NO ./textures/color1_1.xpm

SO ./textures/color2_1.xpm
SO ./textures/color2_1.xpm

WE ./textures/color3_1.xpm
EA ./textures/color4_1.xpm

F 220,100,0
C 255,255,234

11111111111111
10000000001001
10111000000101
100000000000E1
10111100111001
100001001 1001
10000100111001
11111111111111