11111111111111
10000000001001
10111000000101
10000000000001
10111100100011
1000010000E001
10000100000001
11111111111111
