NO ./textures/color1_1.xpm
SO ./textures/color2_1.xpm
WE ./textures/color3_1.xpm
EA ./textures/color4_1.xpm


F 220,100,0
C 255,255,234

111111111111111111
1000000000100111011
101110000001011111
100000000000E1


10111100111001  11111
100001001 1001   1111
10000100111001
111111111111111111111
