11111111111111
10000000111111
10111110111111
10111110000001
10111111111101
10111111111101
10111000000001
10111011111101
10111000000001
10111111111001
10111111111001
101111111110N1
10000000000001
11111111111111
