11111111111111
100W0000001001
10111000000101
10000000000001
10111100100011
10000100000001
10000100000001
11111111111111
