SO ./textures/color1_1.xpm
F 110,110,110
EA ./textures/color2_1.xpm
WE ./textures/color3_1.xpm

NO ./textures/color4_1.xpm
C 41,41,41

            111
            101
            101
            101
            101
            101
111111111111101111111111111
100000000000000000000000001
111111111111101111111111111
            1S1
            111